===R===L======.
=..=...=.....=.
=..=...=.....=.
=3==...=.....l$
.......=.....=.
.......8.....=.
.......L=====R.
.......=.....=.
.......=.....=.
.......=======.

P	1 3
R	1 3