===R===L======.
=..=...=.....=.
=..=...=.....=.
=3==...=.....L$
.......=.....=.
.......8.....=.
.......L=====R.
.......=.....=.
.......=.....=.
.......=======.

P	1 3
R	1 3
SN	13 3
SN	13 6