===......
=.r=r====
=1=.=...=
....=...=
====Rr==F
=....=..=
2....=..2
=....=..=
L====#===
=....=...
=....=...
=====F==$

P	0 6
R	0 6
SN	0 8
SN	4 1
SN	4 4
SN	8 4
SA	5 4