.=====..=====
.=...=..=...=
.=...=..=...=
.=...=..=...=
$f===f==R===l
............=
............=
.==3=R==r===L
.=...=..=...=
.=...=..=...=
.=...=..=...=
.=====..=====

P	3 7