=====........
=...=...=====
=...=...=...4
==f==...=...=
..=.....=...=
..=.====#====
..=.=...=....
..=.=...=....
..=.=...=....
$=#=f====....
..=..........
..4..........
==f==........
=...=........
=...=.....=1=
=...=.....=.=
=2===.....===

P	12 2
R	1 16
SN	2 3
SN	2 12