.....$.......
=====L.......
=....=.......
=....=.......
3====f=F=====
.......=....=
.......=....1
.......======

P	12 6
SN	5 4