===f3==.
=..=..=.
=..=..=.
3..=..=.
=..3..=.
=..=..=.
=..=..=.
=..=..=.
=..=..=.
===f==F$

P	3 4
R	3 4
SA	3 0
SN	3 9