......$......
===f==#==f===
=..=..=..=..=
=..=..=..=..=
f==#==#==#==f
=..=..=..=..=
=..=..=..=..=
f==#==#==#==f
=..=..=..=..=
=..=..=..=..=
f==#==#==#==f
=..=..=..=..=
=..=..=..=..=
2==f==f==f==2

P	0 13
R	12 13
SA	3 13
SA	9 13