.=====..=====
.=...=..=...=
.=...=..=...=
.=...=..=...=
$f===f==R===l
............=
............=
.=3==R==r===L
.=...=..=...=
.=...=..=...=
.=...=..=...=
.=====..=====

P	2 7
SN	5 4