......$......
===l==#==r==2
=..=..=..=..=
=..=..=..=..=
f==#==#==#==f
=..=..=..=..=
=..=..=..=..=
f==#==#==#==f
=..=..=..=..=
=..=..=..=..=
f==#==#==#==f
=..=..=..=..=
=..=..=..=..=
2==F==f==F==2

P	0 13
R	0 13
R	12 1
SA	3 13
SN	6 13
SA	9 13
SA	12 4