====R=L====
=...=.=...=
=...5.5...=
=...=.=...=
L====.====R
=.........=
R====.====L
=...=.=...=
=...=.=...5
=...=.=...=
f===L=R====
$..........

P	4 2
R	6 2
SN	0 4
SN	4 10
SN	6 0
SN	10 6