3==R=F===
=..=.=..=
=..=.=..=
===#=#==f
...=.=..=
===#=#==L
=..=.=..3
=..=.=..=
====.===F
........$

P	0 0
SN	3 0
SN	8 5