....====
....=..=
=8===..=
=......=
========